WWWWWWWWWWWWWWWWWWWWWWWWW
W00000000000000000000000W
W00000001000000000000000W
W00000000000000000f00000W
W00000000200000000000000W
W00000000000000000000000W
W00000000000000000300000W
W00000000V00000000000000W
W00000000000000T00000000W
W0000000000000000000$000W
W00000000000H00000000000W
W000000a000000000000#000W
W00000000000000B00000000W
W000000000b00e0000000000W
W00000000000000000000000W
WWWWWWWWWWWWWWWWWWWWWWWWW