WWWWWWWWWWWWWWWWWWWWWWWWWWWW
W                     VWWWWW
W       1              WWWWW
W                     fWWWWW
W           W          WWWWW
W           W          WWWWW
W           W     3        W
W        H  a          e  #W
W           W  T       WWWWW
W           W          WWWWW
W                      WWWWW
W      b            $  WWWWW
W              B       WWWWW
W  2                   WWWWW
WWWWWWWWWWWWWWWWWWWWWWWWWWWW
