WWWWWWWWWWWWWWWWWW
W1  2     3    # W
W                W
W                W
WWWWWWWWWWWWWWWWWW
