WWWWWWWWWWWWWWWWWWWWWWWW
W0000000000000000000f00W
W0000000100000000000000W
W0000000000000000000000W
W00000000200W0000000000W
W00000000000W0000000000W
W00000000000W0000030000W
W00000000H00a0000000000W
W00000000000W00T0000000W
W00000000000W0000000$00W
W0000000000000000000000W
W000000b000000000000#00W
W00000000000000B0000000W
W0000000000000000000e00W
WWWWWWWWWWWWWWWWWWWWWWWW
